NO textures/simonkraft/bookshelf.xpm
SO textures/simonkraft/bookshelf_01.xpm
WE textures/simonkraft/bookshelf_02.xpm
EA textures/simonkraft/bookshelf_03.xpm

F 0,0,0

C 128,128,128

111111
1S000001
100111111
100111111
100000001
100000001
111111111
